00000000000000000000000000000000000000000000000
00000000000000000000000000000000000000000000000
00000001111111111111111111111111111111110000000
00000010000000000000000000000000000000001000000
00000100000000000000000000000000000000000100000
00001000000000000000100000000000000000000010000
00001000000000000000100000000000000000000010000
00001000000000000000000000000100000000000010000
00001000000100000000000000000111000000000010000
00001000000000000000000000000000000000000010000
00001000000000000000000000000000000000000010000
00001000000000001000000100000000000000000010000
00001000000000000000011111000000010000000010000
00000100000000000000000000000000000000000100000
00000010000000000000000000000000000000001000000
00000001111111111111111111111111111111110000000
00000000000000000000000000000000000000000000000
00000000000000000000000000000000000000000000000